# # # # # # # # # # # # #
# . . . . . . # -10 . . . #
# . S . . . . # . . . . #
# . . . . . . . . . . . #
# . . . . . . # . . . . #
# . . . . . . # . -10 . . #
# # # . # # # # # # . # #
# . . . . . # . . . . . #
# . . -10 . . # . . . . . #
# . . . . . # . . . . . #
# . . . . . . -10 . . G . #
# . . . . . # . . . . . #
# # # # # # # # # # # # #
